height: 6 width: 25 bullets: 20
- 0 0 0 0 0 0 0 0 0 0 0 0 0 0
- 0 0 0 0 0 0 0 0 0 0 0 0 0 0
- 0 0 0 0 0 0 0 0 0 0 0 0 0 0
- 0 s 0 0 0 0 0 0 0 0 0 0 0 e
- 0 0 - 0 e 0 e 0 e 0 e 0 e e
- - - - - - - - - - - - - - -