height: 6 width: 25 bullets: 30
- 0 0 0 0 0 0 0 0 0 0 0 0 0 0
- 0 0 0 0 0 0 0 0 0 0 0 0 0 0
- 0 0 0 0 0 0 0 0 0 0 0 0 0 0
- a a c 0 0 0 s 0 0 0 0 0 0 0
- a c - 0 c a - 0 0 0 0 0 0 0
- - - - - - - - - - - - - - -